......
..##.#.####
.##..###..#
##........#
#@.....#..#
###..###..#
..#..#....#
.##.##.#.##
.#......##
.......##
.#######