......
.......####
.#.....#..#
.#.........
.@.....#...
.#....##...
.....#.....
.#..##.#.##
........##
.......##
.......#