.....#
..##..#####
.##...#...#
##....###..
#..#..#....
###..###...
..#..@....#
.#.....#.##
...#....##
...#...##
##...###