.....#
..##..#####
.##...#...#
##....###.#
#..#..#...#
###..###..#
..#..@....#
.#.....#.##
...#....##
...#...##
########